................
...¨&&*....LDDDD
...........l----
DR.........l----
-r.......LDR----
LDDDDDR..l-r----
l-----r.LDRr----
l-----r.l-rr----
LDDDR-r.l-LDDDDR
DDDDDDDDDDDDDDDD